NO ../bluestone.png

SO textura.txt

WE textura.txt                         
			
EA textura.txt

F 255,100,0

C 225,00,0

11111
10001
1S001
10001
11111