NO textura.txt

SO textura.txt

WE textura.txt                         
			
EA textura.txt

F 255,100,0

C 225,30,0

11111
10001
1N001
11111