NO textura.txt

SO textura.txt

WE textura.txt                         
			
EA textura.txt

F 255,100,0

C 225,30,0

1111111
1000001
1W00001
1111111
