NO textura.txt

SO textura.txt

WE textura.txt                         
			
EA textura.txt

F 255,100,0

C 225,00,0

111111111111111111111111
100000000000000000000001
100000000000000000000001
10000000000N000000000001
100000000000000000000001
111111111110000000000001
100000000000000000000001111111
100000000011111100000000000001
10000000001    101100000000001
100000000011111100000000000001
100000000000000000000001111111
100000000000001111111111
100000000000000000000001
100000000000000000000001
100000000000000000000001
100000000000000000000001
100000000001000000000001
100000000001000000000001
100000000001000000011111
10000000000000000001
100000000000000000011111
100000000000000000000001
100000000000000000000001
111111111111111111111111