NO textura.txt

SO textura.txt

WE textura.txt                         
			
EA textura.txt

F 255,100,0

C 225,30,0

111111111111111
1110000N0000011
111000000000011
111111111111111