NO ./textures/colorstone.png

SO ./textures/wood.png

WE ./textures/mossy.png                    
			
EA ./textures/eagle.png

F 50,100,50

C 200,50,200

111111111111111111111111
110000000000000000000001
100000000000000000000001
100000000000000000000001
100000000000000000000001
100000000000000000000S01
100000000000000000000001
100000000000000000000001
100000000010001000000001
100000000100001000000001
100000001000000100000001
100000110000000011000001
100000100000000000100001
100000111100001111000001
100000000010010000001111
100000000010010000001
100000000010010000001111
100000000001100000000001
100000000000000000000001
100000000000000000000001
100000000000000000000001
100000000000000000000001
110000000000000000000001
111111111111111111111111