NO ./textures/stone_drygrass_alt_tileset_2.png

SO ./textures/bluestone.png

WE ./textures/purplestone.png                    
			
EA ./textures/redbrick.png

F 255,100,0

C 225,0,0

111111111111111111111111111111111111
100000000000000000000000000001111111
10000N000000000111111111111111111111
100000000000000000001111111111111111
111111111111111111111111111111111111
